# A list of file extension followed by the correspending MIME type.

a	application/octet-stream
ai	application/postscript
avi	video/x-msvideo
bin	application/octet-stream
bmp	image/bmp
c	text/plain
class	application/x-java-vm
cpp	text/plain
csh	application/x-csh
css	text/css
djv	image/vnd.djvu
djvu	image/vnd.djvu
dll	application/octet-stream
doc	application/msword
dtd	text/xml
dump	application/octet-stream
exe	application/octet-stream
gif	image/gif
h	text/plain
hpp	text/plain
htm	text/html
html	text/html
jar	application/x-java-archive
jpe	image/jpeg
jpeg	image/jpeg
jpg	image/jpeg
js	application/x-javascript
latex	application/x-latex
mid	audio/midi
midi	audio/midi
mov	video/quicktime
movie	video/x-sgi-movie
mp2	audio/mpeg
mp3	audio/mpeg
mp4	audio/mp4
o	application/octet-stream
ogg	application/x-ogg
pdf	application/pdf
png	image/png
ppt	application/vnd.ms-powerpoint
ps	application/postscript
qt	video/quicktime
rss	application/rss+xml
rtf	text/rtf
sgm	text/sgml
sgml	text/sgml
sh	application/x-sh
so	application/octet-stream
swf	application/x-shockwave-flash
tar	application/x-tar
tcl	application/x-tcl
tex	application/x-tex
tif	image/tiff
tiff	image/tiff
txt	text/plain; charset=utf-8
vrml	model/vrml
wav	audio/x-wav
wma	audio/x-ms-wma
wrl	model/vrml
xht	applicationi/xhtml+xml
xhtml	application/xhtml+xml
xls	application/vnd.ms-excel
xml	text/xml
xsl	text/xml        
zip	application/zip
